0,0,2,1,0,0,0,0
0,0,2,1,0,0,0,0
0,0,2,1,0,0,0,0
0,0,2,1,0,0,0,0
0,0,2,1,0,0,0,0
0,0,2,1,0,0,0,0
4,4,2,1,4,4,4,4
3,3,5,5,3,3,3,3
0,0,2,1,0,0,0,0
0,0,2,1,0,0,0,0
0,0,2,1,0,0,0,0
0,0,2,1,0,0,0,0
0,0,2,1,0,0,0,0